Date reported to Alberta Health,Number of lab tests,Cumulative number of lab tests,Number of cases,Cumulative number of cases,Cumulative number of deaths,Number of deaths,Percent positivity
2020-03-06,60,511,0,0,0,0,5
2020-03-07,281,792,1,2,0,0,0
2020-03-08,454,1246,1,3,0,0,0
2020-03-09,643,1889,4,7,0,0,1.71
2020-03-10,784,2673,9,16,0,0,1.91
2020-03-11,1334,4007,7,23,0,0,0.6
2020-03-12,1147,5154,3,26,0,0,0.26
2020-03-13,1587,6741,8,34,0,0,1.2
2020-03-14,1555,8296,22,56,0,0,1.93
2020-03-15,1834,10130,11,67,0,0,0.87
2020-03-16,1485,11615,24,91,0,0,2.63
2020-03-17,2083,13698,11,102,0,0,0.48
2020-03-18,2878,16576,29,131,1,1,1.88
2020-03-19,2869,19445,32,163,1,0,1.67
2020-03-20,3593,23038,46,209,1,0,1.64
2020-03-21,3507,26545,35,244,1,0,1.17
2020-03-22,2854,29399,47,291,1,0,1.26
2020-03-23,2728,32127,53,344,1,0,1.65
2020-03-24,3143,35270,68,412,1,0,1.81
2020-03-25,1645,36915,63,475,1,0,3.65
2020-03-26,1316,38231,53,528,1,0,2.74
2020-03-27,3697,41928,85,613,1,0,2.41
2020-03-28,2145,44073,54,667,1,0,2
2020-03-29,1929,46002,34,701,5,4,0.98
2020-03-30,2549,48551,40,741,10,5,1.18
2020-03-31,4770,53321,132,873,11,1,2.56
2020-04-01,3610,56931,108,981,12,1,2.3
2020-04-02,4009,60940,122,1103,15,3,2.34
2020-04-03,1723,62663,70,1173,18,3,2.44
2020-04-04,1807,64470,60,1233,23,5,2.6
2020-04-05,1185,65655,42,1275,25,2,3.21
2020-04-06,941,66596,34,1309,28,3,2.66
2020-04-07,1705,68301,53,1362,28,0,2.29
2020-04-08,1288,69589,33,1395,32,4,2.17
2020-04-09,2291,71880,45,1440,36,4,1.48
2020-04-10,2851,74731,49,1489,40,4,1.4
2020-04-11,2240,76971,65,1554,45,5,2.14
2020-04-12,2305,79276,68,1622,45,0,2.52
2020-04-13,2136,81412,68,1690,48,3,2.76
2020-04-14,2572,83984,127,1817,48,0,4.67
2020-04-15,3092,87076,133,1950,50,2,3.85
2020-04-16,3099,90175,146,2096,50,0,4.94
2020-04-17,5238,95413,213,2309,54,4,4.01
2020-04-18,3800,99213,187,2496,57,3,4.79
2020-04-19,4370,103583,201,2697,62,5,4.51
2020-04-20,4009,107592,183,2880,66,4,4.71
2020-04-21,4313,111905,264,3144,72,6,5.91
2020-04-22,4057,115962,294,3438,75,3,7.2
2020-04-23,4471,120433,340,3778,80,5,7.67
2020-04-24,4531,124964,232,4010,80,0,5.16
2020-04-25,4664,129628,222,4232,84,4,4.97
2020-04-26,4301,133929,203,4435,88,4,4.49
2020-04-27,3444,137373,178,4613,90,2,5.14
2020-04-28,4362,141735,249,4862,94,4,5.89
2020-04-29,5077,146812,231,5093,96,2,4.53
2020-04-30,5035,151847,222,5315,100,4,4.37
2020-05-01,2847,154694,141,5456,102,2,4.25
2020-05-02,4970,159664,112,5568,104,2,2.25
2020-05-03,3244,162908,70,5638,106,2,2.37
2020-05-04,2557,165465,79,5717,107,1,2.89
2020-05-05,3032,168497,62,5779,111,4,2.01
2020-05-06,2882,171379,65,5844,112,1,2.22
2020-05-07,4135,175514,87,5931,115,3,2.18
2020-05-08,3781,179295,77,6008,115,0,2.17
2020-05-09,4214,183509,85,6093,117,2,1.97
2020-05-10,3260,186769,71,6164,118,1,2.18
2020-05-11,2793,189562,47,6211,121,3,1.75
2020-05-12,3756,193318,70,6281,124,3,1.86
2020-05-13,4409,197727,62,6343,124,0,1.47
2020-05-14,4767,202494,61,6404,125,1,1.26
2020-05-15,4700,207194,73,6477,126,1,1.57
2020-05-16,3986,211180,54,6531,128,2,1.4
2020-05-17,3189,214369,46,6577,129,1,1.57
2020-05-18,3230,217599,38,6615,131,2,1.24
2020-05-19,2503,220102,43,6658,132,1,1.8
2020-05-20,3277,223379,27,6685,136,4,0.92
2020-05-21,3722,227101,30,6715,138,2,0.83
2020-05-22,3823,230924,27,6742,138,0,0.86
2020-05-23,3861,234785,32,6774,139,1,0.83
2020-05-24,3234,238019,29,6803,139,0,0.87
2020-05-25,2958,240977,13,6816,141,2,0.44
2020-05-26,3056,244033,19,6835,143,2,0.65
2020-05-27,3603,247636,27,6862,143,0,0.78
2020-05-28,3903,251539,28,6890,143,0,0.74
2020-05-29,3862,255401,30,6920,144,1,0.78
2020-05-30,3364,258765,20,6940,144,0,0.62
2020-05-31,3133,261898,34,6974,144,0,1.09
2020-06-01,2734,264632,21,6995,145,1,0.77
2020-06-02,4055,268687,19,7014,146,1,0.62
2020-06-03,4781,273468,18,7032,147,1,0.38
2020-06-04,5416,278884,19,7051,147,0,0.39
2020-06-05,5604,284488,37,7088,148,1,0.75
2020-06-06,5870,290358,23,7111,150,2,0.44
2020-06-07,5490,295848,33,7144,150,0,0.62
2020-06-08,4976,300824,24,7168,151,1,0.52
2020-06-09,5923,306747,38,7206,151,0,0.69
2020-06-10,6850,313597,48,7254,151,0,0.73
2020-06-11,8477,322074,43,7297,151,0,0.51
2020-06-12,6183,328257,27,7324,151,0,0.44
2020-06-13,7665,335922,35,7359,151,0,0.52
2020-06-14,7459,343381,53,7412,151,0,0.76
2020-06-15,6366,349747,36,7448,151,0,0.58
2020-06-16,6970,356717,45,7493,151,0,0.67
2020-06-17,7821,364538,46,7539,152,1,0.64
2020-06-18,9100,373638,46,7585,152,0,0.57
2020-06-19,7399,381037,47,7632,152,0,0.65
2020-06-20,8324,389361,30,7662,152,0,0.38
2020-06-21,6895,396256,33,7695,153,1,0.51
2020-06-22,6542,402798,41,7736,153,0,0.61
2020-06-23,6518,409316,45,7781,153,0,0.81
2020-06-24,6367,415683,25,7806,153,0,0.47
2020-06-25,6634,422317,36,7842,154,1,0.57
2020-06-26,6396,428713,66,7908,154,0,1.13
2020-06-27,6509,435222,37,7945,154,0,0.61
2020-06-28,6997,442219,68,8013,154,0,1.03
2020-06-29,7200,449419,44,8057,154,0,0.64
2020-06-30,6952,456371,33,8090,155,1,0.62
2020-07-01,7675,464046,64,8154,155,0,0.86
2020-07-02,6739,470785,55,8209,155,0,0.91
2020-07-03,5960,476745,30,8239,155,0,0.55
2020-07-04,5544,482289,48,8287,156,1,0.9
2020-07-05,5602,487891,48,8335,156,0,1.09
2020-07-06,6014,493905,49,8384,156,0,0.78
2020-07-07,6268,500173,44,8428,158,2,0.78
2020-07-08,6970,507143,43,8471,159,1,0.66
2020-07-09,7804,514947,74,8545,162,3,0.96
2020-07-10,7528,522475,62,8607,162,0,0.85
2020-07-11,10003,532478,90,8697,162,0,1.01
2020-07-12,7595,540073,78,8775,162,0,1.12
2020-07-13,5809,545882,87,8862,163,1,1.62
2020-07-14,6386,552268,85,8947,166,3,1.44
2020-07-15,8225,560493,115,9062,166,0,1.62
2020-07-16,6485,566978,103,9165,167,1,1.73
2020-07-17,9719,576697,168,9333,167,0,1.89
2020-07-18,6857,583554,102,9435,170,3,1.63
2020-07-19,6961,590515,88,9523,171,1,1.39
2020-07-20,7818,598333,131,9654,173,2,1.69
2020-07-21,8156,606489,136,9790,175,2,1.77
2020-07-22,8230,614719,113,9903,177,2,1.37
2020-07-23,8741,623460,116,10019,179,2,1.4
2020-07-24,10589,634049,117,10136,182,3,1.18
2020-07-25,9855,643904,98,10234,184,2,1.07
2020-07-26,7443,651347,89,10323,187,3,1.36
2020-07-27,7910,659257,81,10404,190,3,1.13
2020-07-28,8989,668246,131,10535,194,4,1.57
2020-07-29,8674,676920,118,10653,195,1,1.43
2020-07-30,8394,685314,124,10777,196,1,1.57
2020-07-31,11514,696828,99,10876,200,4,1.01
2020-08-01,9148,705976,67,10943,200,0,0.75
2020-08-02,6934,712910,73,11016,200,0,1.1
2020-08-03,7246,720156,64,11080,203,3,1.02
2020-08-04,7203,727359,94,11174,204,1,1.36
2020-08-05,7991,735350,61,11235,207,3,0.76
2020-08-06,8561,743911,128,11363,209,2,1.55
2020-08-07,8780,752691,111,11474,209,0,1.34
2020-08-08,10167,762858,97,11571,214,5,0.97
2020-08-09,7414,770272,45,11616,216,2,0.63
2020-08-10,7061,777333,86,11702,218,2,1.39
2020-08-11,8078,785411,116,11818,220,2,1.57
2020-08-12,7752,793163,72,11890,222,2,1.02
2020-08-13,8210,801373,81,11971,222,0,1.12
2020-08-14,10890,812263,104,12075,222,0,0.99
2020-08-15,8658,820921,83,12158,225,3,0.95
2020-08-16,8693,829614,95,12253,226,1,1.13
2020-08-17,8034,837648,85,12338,227,1,1.19
2020-08-18,9037,846685,81,12419,228,1,1.01
2020-08-19,9294,855979,101,12520,229,1,1.25
2020-08-20,9870,865849,140,12660,229,0,1.45
2020-08-21,10176,876025,88,12748,231,2,0.9
2020-08-22,10096,886121,103,12851,232,1,1.05
2020-08-23,8498,894619,70,12921,236,4,0.87
2020-08-24,8446,903065,73,12994,236,0,0.96
2020-08-25,9248,912313,125,13119,236,0,1.44
2020-08-26,10103,922416,104,13223,237,1,1.17
2020-08-27,10997,933413,153,13376,237,0,1.42
2020-08-28,10223,943636,142,13518,237,0,1.44
2020-08-29,11224,954860,181,13699,237,0,1.75
2020-08-30,12265,967125,109,13808,238,1,1.02
2020-08-31,9342,976467,152,13960,239,1,1.69
2020-09-01,8305,984772,109,14069,240,1,1.38
2020-09-02,9557,994329,132,14201,240,0,1.44
2020-09-03,10721,1005050,157,14358,241,1,1.5
2020-09-04,11395,1016445,169,14527,242,1,1.61
2020-09-05,11374,1027819,168,14695,244,2,1.58
2020-09-06,12100,1039919,134,14829,245,1,1.19
2020-09-07,12570,1052489,147,14976,249,4,1.26
2020-09-08,10507,1062996,97,15073,250,1,1
2020-09-09,9716,1072712,113,15186,250,0,1.25
2020-09-10,11983,1084695,116,15302,251,1,0.98
2020-09-11,12763,1097458,115,15417,252,1,0.94
2020-09-12,18919,1116377,166,15583,252,0,0.89
2020-09-13,14459,1130836,137,15720,252,0,1
2020-09-14,12992,1143828,123,15843,252,0,0.96
2020-09-15,12546,1156374,170,16013,252,0,1.41
2020-09-16,18136,1174510,182,16195,252,0,1.05
2020-09-17,12707,1187217,125,16320,252,0,1.05
2020-09-18,13830,1201047,137,16457,252,0,1.03
2020-09-19,14062,1215109,120,16577,253,1,0.89
2020-09-20,16261,1231370,152,16729,254,1,0.96
2020-09-21,13500,1244870,156,16885,256,2,1.24
2020-09-22,13663,1258533,128,17013,258,2,1
2020-09-23,13663,1272196,129,17142,260,2,1.04
2020-09-24,16685,1288881,124,17266,260,0,0.85
2020-09-25,14630,1303511,175,17441,261,1,1.28
2020-09-26,18583,1322094,155,17596,262,1,0.91
2020-09-27,14135,1336229,121,17717,263,1,0.94
2020-09-28,12583,1348812,127,17844,263,0,1.08
2020-09-29,15567,1364379,175,18019,264,1,1.16
2020-09-30,15243,1379622,154,18173,268,4,1.05
2020-10-01,14111,1393733,147,18320,271,3,1.16
2020-10-02,15888,1409621,222,18542,275,4,1.5
2020-10-03,14894,1424515,195,18737,277,2,1.35
2020-10-04,14479,1438994,213,18950,278,1,1.49
2020-10-05,18042,1457036,206,19156,278,0,1.2
2020-10-06,11770,1468806,243,19399,280,2,2.12
2020-10-07,13980,1482786,218,19617,281,1,1.68
2020-10-08,15356,1498142,186,19803,282,1,1.35
2020-10-09,16199,1514341,258,20061,283,1,1.67
2020-10-10,13888,1528229,250,20311,284,1,1.93
2020-10-11,16677,1544906,241,20552,285,1,1.57
2020-10-12,11474,1556380,221,20773,285,0,2.03
2020-10-13,14901,1571281,242,21015,287,2,1.7
2020-10-14,12795,1584076,242,21257,287,0,2.01
2020-10-15,14179,1598255,319,21576,288,1,2.36
2020-10-16,16032,1614287,307,21883,289,1,2.01
2020-10-17,12565,1626852,225,22108,289,0,1.85
2020-10-18,13598,1640450,370,22478,291,2,2.89
2020-10-19,13019,1653469,324,22802,293,2,2.63
2020-10-20,14955,1668424,392,23194,295,2,2.88
2020-10-21,14333,1682757,436,23630,297,2,3.18
2020-10-22,15549,1698306,442,24072,301,4,2.89
2020-10-23,16389,1714695,390,24462,304,3,2.5
2020-10-24,17134,1731829,578,25040,306,2,3.54
2020-10-25,12689,1744518,500,25540,307,1,4.12
2020-10-26,9649,1754167,416,25956,309,2,4.57
2020-10-27,10962,1765129,407,26363,314,5,3.94
2020-10-28,12858,1777987,479,26842,320,6,3.94
2020-10-29,13649,1791636,614,27456,323,3,4.83
2020-10-30,13827,1805463,589,28045,326,3,4.39
2020-10-31,13203,1818666,524,28569,333,7,4.17
2020-11-01,11638,1830304,605,29174,338,5,5.34
2020-11-02,8970,1839274,571,29745,341,3,6.61
2020-11-03,11167,1850441,537,30282,350,9,5.05
2020-11-04,14099,1864540,771,31053,354,4,5.74
2020-11-05,14153,1878693,735,31788,361,7,5.48
2020-11-06,15030,1893723,825,32613,368,7,5.89
2020-11-07,12167,1905890,640,33253,373,5,5.59
2020-11-08,11616,1917506,630,33883,383,10,5.72
2020-11-09,9323,1926829,724,34607,389,6,8.22
2020-11-10,12679,1939508,676,35283,397,8,5.76
2020-11-11,14923,1954431,854,36137,400,3,5.98
2020-11-12,14035,1968466,896,37033,407,7,6.93
2020-11-13,14322,1982788,1017,38050,413,6,7.71
2020-11-14,15603,1998391,981,39031,422,9,6.72
2020-11-15,12217,2010608,852,39883,435,13,7.45
2020-11-16,11539,2022147,765,40648,449,14,7
2020-11-17,13453,2035600,729,41377,459,10,5.91
2020-11-18,16471,2052071,1102,42479,466,7,7.24
2020-11-19,17768,2069839,1140,43619,476,10,7.05
2020-11-20,19342,2089181,1333,44952,484,8,7.45
2020-11-21,19571,2108752,1562,46514,493,9,8.54
2020-11-22,19567,2128319,1528,48042,504,11,8.33
2020-11-23,13649,2141968,1120,49162,514,10,8.78
2020-11-24,15715,2157683,1271,50433,524,10,8.53
2020-11-25,16000,2173683,1084,51517,533,9,7.28
2020-11-26,16355,2190038,1228,52745,545,12,7.92
2020-11-27,21749,2211787,1714,54459,558,13,8.39
2020-11-28,23385,2235172,1593,56052,567,9,7.32
2020-11-29,20591,2255763,1710,57762,579,12,8.79
2020-11-30,15884,2271647,1317,59079,595,16,8.82
2020-12-01,18517,2290164,1695,60774,607,12,9.61
2020-12-02,19698,2309862,1851,62625,625,18,9.81
2020-12-03,17309,2327171,1794,64419,640,15,11.15
2020-12-04,21186,2348357,1880,66299,666,26,9.47
2020-12-05,23544,2371901,1828,68127,681,15,8.3
2020-12-06,20472,2392373,1725,69852,700,19,9.02
2020-12-07,19195,2411568,1794,71646,723,23,9.85
2020-12-08,16894,2428462,1494,73140,736,13,9.48
2020-12-09,16891,2445353,1596,74736,757,21,9.98
2020-12-10,21106,2466459,1745,76481,776,19,8.93
2020-12-11,20347,2486806,1597,78078,789,13,8.41
2020-12-12,21833,2508639,1709,79787,814,25,8.35
2020-12-13,20496,2529135,1865,81652,830,16,9.52
2020-12-14,16468,2545603,1342,82994,850,20,8.9
2020-12-15,17645,2563248,1287,84281,873,23,7.71
2020-12-16,19960,2583208,1592,85873,897,24,8.46
2020-12-17,19671,2602879,1461,87334,918,21,7.97
2020-12-18,18664,2621543,1369,88703,946,28,7.93
2020-12-19,18156,2639699,1307,90010,963,17,7.62
2020-12-20,18499,2658198,1251,91261,976,13,7.37
2020-12-21,14366,2672564,1052,92313,998,22,7.73
2020-12-22,19445,2692009,1336,93649,1023,25,7.45
2020-12-23,15747,2707756,1130,94779,1044,21,7.67
2020-12-24,18182,2725938,1240,96019,1066,22,7.32
2020-12-25,14405,2740343,904,96923,1093,27,6.66
2020-12-26,7110,2747453,486,97409,1117,24,7.44
2020-12-27,9892,2757345,955,98364,1144,27,10.35
2020-12-28,11286,2768631,896,99260,1160,16,8.32
2020-12-29,15059,2783690,1364,100624,1180,20,9.39
2020-12-30,17143,2800833,1263,101887,1198,18,7.65
2020-12-31,16684,2817517,1360,103247,1214,16,8.57
2021-01-01,12952,2830469,921,104168,1238,24,7.61
2021-01-02,8365,2838834,466,104634,1268,30,5.86
2021-01-03,12232,2851066,1138,105772,1292,24,9.86
2021-01-04,10628,2861694,878,106650,1317,25,8.62
2021-01-05,16450,2878144,1148,107798,1340,23,7.28
2021-01-06,15094,2893238,966,108764,1366,26,6.7
2021-01-07,16994,2910232,1176,109940,1386,20,7.21
2021-01-08,13667,2923899,982,110922,1403,17,7.54
2021-01-09,12367,2936266,809,111731,1427,24,6.87
2021-01-10,9894,2946160,627,112358,1455,28,6.65
2021-01-11,9401,2955561,675,113033,1472,17,7.5
2021-01-12,15960,2971521,867,113900,1496,24,5.8
2021-01-13,16303,2987824,966,114866,1506,10,6.31
2021-01-14,13640,3001464,779,115645,1521,15,5.91
2021-01-15,12472,3013936,702,116347,1538,17,5.92
2021-01-16,11527,3025463,743,117090,1557,19,6.81
2021-01-17,8613,3034076,461,117551,1574,17,5.65
2021-01-18,7730,3041806,462,118013,1586,12,6.27
2021-01-19,14722,3056528,670,118683,1610,24,4.88
2021-01-20,14097,3070625,672,119355,1626,16,5.03
2021-01-21,13043,3083668,642,119997,1639,13,5.09
2021-01-22,10918,3094586,567,120564,1652,13,5.52
2021-01-23,10256,3104842,451,121015,1669,17,4.57
2021-01-24,7203,3112045,358,121373,1681,12,5.28
2021-01-25,8317,3120362,362,121735,1697,16,4.48
2021-01-26,12891,3133253,468,122203,1704,7,3.82
2021-01-27,12336,3145589,473,122676,1713,9,4.09
2021-01-28,11608,3157197,519,123195,1724,11,4.63
2021-01-29,10396,3167593,388,123583,1732,8,3.89
2021-01-30,8968,3176561,468,124051,1741,9,5.45
2021-01-31,7305,3183866,351,124402,1748,7,5
2021-02-01,7913,3191779,280,124682,1757,9,3.65
2021-02-02,13072,3204851,456,125138,1765,8,3.66
2021-02-03,11521,3216372,403,125541,1778,13,3.64
2021-02-04,10002,3226374,394,125935,1783,5,4.12
2021-02-05,10045,3236419,361,126296,1794,11,3.78
2021-02-06,8250,3244669,352,126648,1799,5,4.34
2021-02-07,6196,3250865,268,126916,1807,8,4.52
2021-02-08,7015,3257880,219,127135,1812,5,3.31
2021-02-09,10888,3268768,335,127470,1820,8,3.27
2021-02-10,9976,3278744,348,127818,1828,8,3.6
2021-02-11,8418,3287162,318,128136,1841,13,3.85
2021-02-12,8079,3295241,301,128437,1848,7,3.85
2021-02-13,7984,3303225,286,128723,1851,3,3.81
2021-02-14,5396,3308621,244,128967,1854,3,4.63
2021-02-15,5239,3313860,260,129227,1859,5,5.33
2021-02-16,7489,3321349,286,129513,1864,5,4.07
2021-02-17,10302,3331651,420,129933,1866,2,4.39
2021-02-18,9387,3341038,331,130264,1872,6,3.7
2021-02-19,8398,3349436,384,130648,1876,4,4.8
2021-02-20,7546,3356982,327,130975,1877,1,4.52
2021-02-21,6074,3363056,268,131243,1881,4,4.63
2021-02-22,6338,3369394,277,131520,1886,5,4.48
2021-02-23,9485,3378879,425,131945,1887,1,4.83
2021-02-24,9232,3388111,404,132349,1890,3,4.57
2021-02-25,9226,3397337,355,132704,1895,5,4.05
2021-02-26,7777,3405114,413,133117,1900,5,5.54
2021-02-27,7523,3412637,301,133418,1902,2,4.28
2021-02-28,5957,3418594,287,133705,1905,3,5.1
2021-03-01,5870,3424464,262,133967,1908,3,4.62
2021-03-02,10365,3434829,400,134367,1912,4,3.94
2021-03-03,9498,3444327,333,134700,1913,1,3.7
2021-03-04,10581,3454908,408,135108,1915,2,4.07
2021-03-05,8149,3463057,336,135444,1918,3,4.2
2021-03-06,8099,3471156,306,135750,1921,3,3.93
2021-03-07,5493,3476649,250,136000,1922,1,4.53
2021-03-08,5445,3482094,252,136252,1927,5,4.74
2021-03-09,10419,3492513,385,136637,1929,2,3.79
2021-03-10,10187,3502700,405,137042,1934,5,4.13
2021-03-11,9921,3512621,447,137489,1938,4,4.65
2021-03-12,8891,3521512,426,137915,1943,5,4.99
2021-03-13,8353,3529865,376,138291,1947,4,4.66
2021-03-14,6635,3536500,364,138655,1951,4,5.73
2021-03-15,6030,3542530,349,139004,1954,3,6.09
2021-03-16,10846,3553376,507,139511,1955,1,4.91
2021-03-17,10957,3564333,516,140027,1955,0,4.95
2021-03-18,11928,3576261,669,140696,1958,3,5.78
2021-03-19,9993,3586254,528,141224,1959,1,5.32
2021-03-20,11434,3597688,545,141769,1962,3,5.03
2021-03-21,7559,3605247,456,142225,1966,4,6.2
2021-03-22,7349,3612596,481,142706,1970,4,6.89
2021-03-23,12853,3625449,677,143383,1972,2,5.42
2021-03-24,14075,3639524,762,144145,1974,2,5.51
2021-03-25,13346,3652870,727,144872,1980,6,5.66
2021-03-26,11533,3664403,655,145527,1984,4,5.84
2021-03-27,11985,3676388,640,146167,1984,0,5.57
2021-03-28,8377,3684765,540,146707,1987,3,6.71
2021-03-29,8101,3692866,622,147329,1989,2,7.91
2021-03-30,13761,3706627,895,148224,1992,3,6.66
2021-03-31,13645,3720272,878,149102,1995,3,6.75
2021-04-01,13292,3733564,1078,150180,1996,1,8.64
2021-04-02,12123,3745687,1065,151245,1996,0,9.03
2021-04-03,11204,3756891,936,152181,1999,3,8.69
2021-04-04,9098,3765989,867,153048,2000,1,9.85
2021-04-05,9179,3775168,930,153978,2001,1,10.7
2021-04-06,14094,3789262,1365,155343,2001,0,9.97
2021-04-07,15245,3804507,1414,156757,2004,3,9.61
2021-04-08,15655,3820162,1533,158290,2009,5,10.16
2021-04-09,14406,3834568,1281,159571,2009,0,9.27
2021-04-10,14919,3849487,1171,160742,2012,3,8.23
2021-04-11,12329,3861816,1096,161838,2017,5,9.38
2021-04-12,11988,3873804,1052,162890,2020,3,9.08
2021-04-13,15777,3889581,1433,164323,2024,4,9.34
2021-04-14,17255,3906836,1649,165972,2028,4,9.83
2021-04-15,16927,3923763,1606,167578,2030,2,9.89
2021-04-16,16410,3940173,1501,169079,2032,2,9.49
2021-04-17,15389,3955562,1474,170553,2035,3,10.03
2021-04-18,12606,3968168,1356,171909,2038,3,11.07
2021-04-19,13195,3981363,1348,173257,2040,2,10.59
2021-04-20,18455,3999818,1729,174986,2045,5,9.74
2021-04-21,17574,4017392,1842,176828,2050,5,10.86
2021-04-22,17620,4035012,1672,178500,2057,7,9.88
2021-04-23,17748,4052760,1513,180013,2062,5,8.78
2021-04-24,17055,4069815,1446,181459,2068,6,8.75
2021-04-25,14885,4084700,1492,182951,2074,6,10.41
2021-04-26,13770,4098470,1547,184498,2077,3,11.58
2021-04-27,19000,4117470,1835,186333,2083,6,9.97
2021-04-28,20601,4138071,2070,188403,2089,6,10.19
2021-04-29,19001,4157072,1995,190398,2092,3,10.77
2021-04-30,20495,4177567,2411,192809,2097,5,12.16
2021-05-01,16626,4194193,1701,194510,2100,3,10.6
2021-05-02,15111,4209304,1970,196480,2106,6,13.45
2021-05-03,14601,4223905,1792,198272,2111,5,12.51
2021-05-04,20544,4244449,2281,200553,2111,0,11.4
2021-05-05,19973,4264422,2183,202736,2114,3,11.35
2021-05-06,18956,4283378,1944,204680,2115,1,10.75
2021-05-07,18859,4302237,2050,206730,2118,3,11.22
2021-05-08,15535,4317772,1583,208313,2123,5,10.48
2021-05-09,13991,4331763,1570,209883,2126,3,11.79
2021-05-10,11912,4343675,1511,211394,2131,5,13.17
2021-05-11,17587,4361262,1813,213207,2133,2,10.67
2021-05-12,15295,4376557,1591,214798,2139,6,10.72
2021-05-13,15067,4391624,1485,216283,2145,6,10.21
2021-05-14,12963,4404587,1238,217521,2148,3,9.8
2021-05-15,11885,4416472,1132,218653,2151,3,9.81
2021-05-16,7011,4423483,718,219371,2155,4,10.47
2021-05-17,8103,4431586,918,220289,2160,5,11.64
2021-05-18,10422,4442008,955,221244,2164,4,9.34
2021-05-19,9064,4451072,829,222073,2166,2,9.52
2021-05-20,10178,4461250,756,222829,2171,5,7.83
2021-05-21,9541,4470791,635,223464,2179,8,6.95
2021-05-22,6960,4477751,552,224016,2186,7,8.2
2021-05-23,5096,4482847,447,224463,2194,8,9.01
2021-05-24,4015,4486862,388,224851,2200,6,10.21
2021-05-25,5989,4492851,407,225258,2204,4,7.16
2021-05-26,9032,4501883,540,225798,2206,2,6.2
2021-05-27,7711,4509594,538,226336,2213,7,7.03
2021-05-28,6893,4516487,409,226745,2218,5,6.12
2021-05-29,6593,4523080,397,227142,2221,3,6.16
2021-05-30,4413,4527493,259,227401,2225,4,5.98
2021-05-31,4120,4531613,213,227614,2227,2,5.53
2021-06-01,8361,4539974,430,228044,2230,3,5.76
2021-06-02,6811,4546785,309,228353,2241,11,4.62
2021-06-03,5815,4552600,241,228594,2243,2,4.04
2021-06-04,6873,4559473,298,228892,2244,1,4.79
2021-06-05,5337,4564810,232,229124,2245,1,4.57
2021-06-06,4026,4568836,159,229283,2249,4,3.95
2021-06-07,3444,4572280,141,229424,2252,3,4.21
2021-06-08,8550,4580830,319,229743,2254,2,3.89
2021-06-09,5493,4586323,172,229915,2259,5,3.17
2021-06-10,6677,4593000,178,230093,2264,5,2.79
2021-06-11,5476,4598476,176,230269,2265,1,3.29
2021-06-12,5803,4604279,163,230432,2267,2,2.91
2021-06-13,3323,4607602,129,230561,2271,4,4
2021-06-14,4482,4612084,129,230690,2276,5,3.06
2021-06-15,6708,4618792,145,230835,2280,4,2.16
2021-06-16,6047,4624839,141,230976,2280,0,2.45
2021-06-17,5578,4630417,119,231095,2287,7,2.19
2021-06-18,5059,4635476,123,231218,2288,1,2.51
2021-06-19,4877,4640353,86,231304,2288,0,1.76
2021-06-20,2837,4643190,53,231357,2291,3,1.9
2021-06-21,5017,4648207,67,231424,2291,0,1.34
2021-06-22,6335,4654542,100,231524,2291,0,1.63
2021-06-23,5722,4660264,80,231604,2291,0,1.45
2021-06-24,7072,4667336,93,231697,2292,1,1.43
2021-06-25,6086,4673422,77,231774,2294,2,1.38
2021-06-26,4587,4678009,45,231819,2295,1,0.98
2021-06-27,4488,4682497,40,231859,2298,3,0.85
2021-06-28,3452,4685949,55,231914,2299,1,1.54
2021-06-29,6333,4692282,75,231989,2299,0,1.12
2021-06-30,5248,4697530,60,232049,2299,0,1.28
2021-07-01,5492,4703022,36,232085,2302,3,0.69
2021-07-02,3931,4706953,34,232119,2302,0,1.04
2021-07-03,4208,4711161,52,232171,2302,0,1.26
2021-07-04,4268,4715429,39,232210,2303,1,0.94
2021-07-05,4419,4719848,36,232246,2303,0,0.79
2021-07-06,6162,4726010,57,232303,2304,1,0.88
2021-07-07,5898,4731908,49,232352,2304,0,0.86
2021-07-08,7316,4739224,57,232409,2304,0,0.78
2021-07-09,5842,4745066,36,232445,2304,0,0.62
2021-07-10,6021,4751087,31,232476,2304,0,0.5
2021-07-11,4012,4755099,30,232506,2307,3,0.75
2021-07-12,4994,4760093,32,232538,2307,0,0.7
2021-07-13,6858,4766951,34,232572,2308,1,0.52
2021-07-14,6214,4773165,49,232621,2310,2,0.8
2021-07-15,6371,4779536,52,232673,2311,1,0.89
2021-07-16,5513,4785049,51,232724,2312,1,0.94
2021-07-17,5355,4790404,40,232764,2313,1,0.82
2021-07-18,4347,4794751,41,232805,2313,0,1.01
2021-07-19,5008,4799759,61,232866,2313,0,1.22
2021-07-20,6483,4806242,89,232955,2315,2,1.47
2021-07-21,6626,4812868,96,233051,2317,2,1.45
2021-07-22,7621,4820489,167,233218,2317,0,2.27
2021-07-23,6082,4826571,145,233363,2318,1,2.48
2021-07-24,6291,4832862,138,233501,2318,0,2.19
2021-07-25,5371,4838233,92,233593,2318,0,1.77
2021-07-26,5428,4843661,134,233727,2319,1,2.54
2021-07-27,7131,4850792,205,233932,2319,0,2.94
2021-07-28,7864,4858656,222,234154,2321,2,2.9
2021-07-29,8291,4866947,196,234350,2321,0,2.48
2021-07-30,6701,4873648,231,234581,2322,1,3.69
2021-07-31,6027,4879675,223,234804,2322,0,3.83
2021-08-01,4392,4884067,143,234947,2322,0,3.39
2021-08-02,4478,4888545,123,235070,2322,0,2.79
2021-08-03,5434,4893979,203,235273,2322,0,3.9
2021-08-04,7475,4901454,394,235667,2323,1,5.55
2021-08-05,7299,4908753,365,236032,2325,2,5.25
2021-08-06,7801,4916554,391,236423,2327,2,5.19
2021-08-07,7708,4924262,376,236799,2327,0,5.11
2021-08-08,4472,4928734,240,237039,2328,1,5.59
2021-08-09,5446,4934180,285,237324,2328,0,5.6
2021-08-10,8640,4942820,504,237828,2328,0,6.22
2021-08-11,8607,4951427,547,238375,2328,0,6.66
2021-08-12,9314,4960741,581,238956,2328,0,6.3
2021-08-13,8016,4968757,567,239523,2330,2,7.32
2021-08-14,7153,4975910,449,239972,2330,0,6.36
2021-08-15,5331,4981241,389,240361,2332,2,7.52
2021-08-16,5495,4986736,409,240770,2332,0,7.88
2021-08-17,9230,4995966,691,241461,2334,2,7.83
2021-08-18,10008,5005974,810,242271,2339,5,8.56
2021-08-19,9034,5015008,740,243011,2341,2,8.61
2021-08-20,8977,5023985,811,243822,2342,1,9.49
2021-08-21,8423,5032408,679,244501,2344,2,8.42
2021-08-22,5618,5038026,470,244971,2348,4,9.02
2021-08-23,6028,5044054,641,245612,2353,5,11.1
2021-08-24,11789,5055843,1077,246689,2357,4,9.62
2021-08-25,10601,5066444,1102,247791,2358,1,10.8
2021-08-26,11591,5078035,1172,248963,2362,4,10.46
2021-08-27,11448,5089483,1226,250189,2366,4,11.22
2021-08-28,9543,5099026,957,251146,2370,4,10.32
2021-08-29,8356,5107382,867,252013,2373,3,10.7
2021-08-30,7514,5114896,918,252931,2380,7,12.74
2021-08-31,12171,5127067,1340,254271,2386,6,11.33
2021-09-01,12474,5139541,1339,255610,2389,3,11.15
2021-09-02,12627,5152168,1414,257024,2394,5,11.79
2021-09-03,10477,5162645,1310,258334,2402,8,13.09
2021-09-04,12867,5175512,1449,259783,2412,10,11.56
2021-09-05,7526,5183038,811,260594,2422,10,11.27
2021-09-06,10452,5193490,1296,261890,2431,9,12.95
2021-09-07,10777,5204267,1219,263109,2438,7,11.8
2021-09-08,13851,5218118,1498,264607,2445,7,11.27
2021-09-09,13681,5231799,1474,266081,2455,10,11.22
2021-09-10,14591,5246390,1649,267730,2464,9,11.77
2021-09-11,12218,5258608,1492,269222,2469,5,12.42
2021-09-12,13372,5271980,1592,270814,2480,11,12.21
2021-09-13,11942,5283922,1413,272227,2493,13,12.4
2021-09-14,15896,5299818,1630,273857,2505,12,10.77
2021-09-15,16432,5316250,1726,275583,2521,16,10.92
2021-09-16,17394,5333644,2003,277586,2535,14,11.92
2021-09-17,16432,5350076,1596,279182,2550,15,10.14
2021-09-18,16561,5366637,1589,280771,2565,15,9.94
2021-09-19,13449,5380086,1434,282205,2582,17,11.13
2021-09-20,13723,5393809,1519,283724,2596,14,11.63
2021-09-21,14584,5408393,1312,285036,2615,19,9.37
2021-09-22,17999,5426392,1685,286721,2625,10,9.75
2021-09-23,16952,5443344,1670,288391,2636,11,10.26
2021-09-24,15935,5459279,1873,290264,2653,17,12.19
2021-09-25,14885,5474164,1525,291789,2668,15,10.61
2021-09-26,15085,5489249,1755,293544,2686,18,12.03
2021-09-27,11182,5500431,1271,294815,2698,12,11.74
2021-09-28,15080,5515511,1704,296519,2713,15,11.66
2021-09-29,17650,5533161,1721,298240,2731,18,10.18
2021-09-30,15893,5549054,1649,299889,2744,13,10.73
2021-10-01,14548,5563602,1606,301495,2757,13,11.38
2021-10-02,14348,5577950,1285,302780,2784,27,9.37
2021-10-03,10445,5588395,1129,303909,2797,13,11.19
2021-10-04,8043,5596438,696,304605,2812,15,9.06
2021-10-05,15433,5611871,1263,305868,2821,9,8.46
2021-10-06,15642,5627513,1245,307113,2832,11,8.34
2021-10-07,14779,5642292,1267,308380,2849,17,8.93
2021-10-08,13998,5656290,1086,309466,2863,14,8.03
2021-10-09,11652,5667942,1041,310507,2877,14,9.29
2021-10-10,7745,5675687,637,311144,2898,21,8.74
2021-10-11,7368,5683055,602,311746,2919,21,8.59
2021-10-12,8651,5691706,652,312398,2932,13,7.93
2021-10-13,12754,5704460,930,313328,2945,13,7.61
2021-10-14,14079,5718539,1044,314372,2958,13,7.67
2021-10-15,11647,5730186,772,315144,2975,17,6.97
2021-10-16,11450,5741636,795,315939,2982,7,7.08
2021-10-17,7184,5748820,608,316547,2992,10,8.76
2021-10-18,8045,5756865,531,317078,3004,12,6.86
2021-10-19,12133,5768998,807,317885,3014,10,6.83
2021-10-20,11912,5780910,773,318658,3024,10,6.72
2021-10-21,10750,5791660,666,319324,3030,6,6.23
2021-10-22,10806,5802466,704,320028,3040,10,6.75
2021-10-23,8705,5811171,522,320550,3053,13,6.19
2021-10-24,6437,5817608,366,320916,3063,10,6.04
2021-10-25,7798,5825406,457,321373,3071,8,6.09
2021-10-26,11371,5836777,626,321999,3077,6,5.71
2021-10-27,10291,5847068,541,322540,3090,13,5.47
2021-10-28,10515,5857583,607,323147,3096,6,6.05
2021-10-29,9399,5866982,530,323677,3105,9,5.95
2021-10-30,8254,5875236,339,324016,3116,11,4.16
2021-10-31,6725,5881961,341,324357,3121,5,5.25
2021-11-01,7547,5889508,326,324683,3126,5,4.56
2021-11-02,10363,5899871,489,325172,3132,6,4.97
2021-11-03,12411,5912282,540,325712,3136,4,4.57
2021-11-04,11509,5923791,468,326180,3141,5,4.24
2021-11-05,11493,5935284,590,326770,3146,5,5.22
2021-11-06,8973,5944257,433,327203,3154,8,4.98
2021-11-07,5521,5949778,287,327490,3158,4,5.22
2021-11-08,8341,5958119,426,327916,3165,7,5.25
2021-11-09,11179,5969298,500,328416,3170,5,4.6
2021-11-10,11594,5980892,468,328884,3176,6,4.16
2021-11-11,8849,5989741,376,329260,3183,7,4.38
2021-11-12,7982,5997723,435,329695,3184,1,5.78
2021-11-13,7150,6004873,357,330052,3193,9,5.08
2021-11-14,6688,6011561,289,330341,3198,5,4.53
2021-11-15,6428,6017989,321,330662,3202,4,5.13
2021-11-16,9745,6027734,416,331078,3204,2,4.39
2021-11-17,8968,6036702,388,331466,3206,2,4.46
2021-11-18,8688,6045390,417,331883,3210,4,4.98
2021-11-19,9454,6054844,472,332355,3215,5,5.2
2021-11-20,7621,6062465,379,332734,3217,2,5.2
2021-11-21,4839,6067304,270,333004,3225,8,5.93
2021-11-22,5326,6072630,271,333275,3227,2,5.43
2021-11-23,10437,6083067,473,333748,3228,1,4.67
2021-11-24,9618,6092685,396,334144,3231,3,4.29
2021-11-25,8714,6101399,363,334507,3235,4,4.3
2021-11-26,7489,6108888,323,334830,3240,5,4.65
2021-11-27,6631,6115519,251,335081,3242,2,3.92
2021-11-28,5058,6120577,231,335312,3246,4,4.82
2021-11-29,5358,6125935,231,335543,3251,5,4.4
2021-11-30,10767,6136702,433,335976,3254,3,4.14
2021-12-01,9474,6146176,364,336340,3256,2,3.96
2021-12-02,9705,6155881,342,336682,3258,2,3.61
2021-12-03,8424,6164305,347,337029,3260,2,4.27
2021-12-04,6957,6171262,247,337276,3263,3,3.61
2021-12-05,5141,6176403,184,337460,3267,4,3.75
2021-12-06,5491,6181894,234,337694,3269,2,4.46
2021-12-07,10715,6192609,384,338078,3269,0,3.75
2021-12-08,10056,6202665,354,338432,3270,1,3.68
2021-12-09,9204,6211869,344,338776,3271,1,3.81
2021-12-10,8538,6220407,312,339088,3273,2,3.87
2021-12-11,6495,6226902,259,339347,3275,2,4.23
2021-12-12,5765,6232667,201,339548,3276,1,3.82
2021-12-13,6433,6239100,276,339824,3277,1,4.57
2021-12-14,10116,6249216,444,340268,3281,4,4.63
2021-12-15,9604,6258820,467,340735,3282,1,5.05
2021-12-16,9712,6268532,547,341282,3284,2,5.82
2021-12-17,10056,6278588,619,341901,3287,3,6.32
2021-12-18,8711,6287299,710,342611,3290,3,8.33
2021-12-19,6507,6293806,563,343174,3291,1,8.82
2021-12-20,7305,6301111,790,343964,3293,2,11.02
2021-12-21,11544,6312655,1354,345318,3295,2,12.01
2021-12-22,11893,6324548,1573,346891,3297,2,13.55
2021-12-23,11555,6336103,1969,348860,3299,2,17.28
2021-12-24,11465,6347568,2451,351311,3300,1,21.6
2021-12-25,7238,6354806,1571,352882,3300,0,22.08
2021-12-26,4074,6358880,687,353569,3303,3,17.45
2021-12-27,6472,6365352,1378,354947,3306,3,21.72
2021-12-28,9405,6374757,2769,357716,3309,3,29.92
2021-12-29,13257,6388014,3969,361685,3311,2,30.41
2021-12-30,13399,6401413,4347,366032,3314,3,32.92
2021-12-31,12794,6414207,4339,370371,3315,1,34.6
2022-01-01,9487,6423694,3197,373568,3318,3,34.49
2022-01-02,7117,6430811,1957,375525,3322,4,28.27
2022-01-03,8284,6439095,2935,378460,3326,4,36.3
2022-01-04,12781,6451876,4682,383142,3329,3,37.24
2022-01-05,12381,6464257,4755,387897,3332,3,39.19
2022-01-06,16288,6480545,6125,394022,3335,3,38.37
2022-01-07,15105,6495650,6116,400138,3340,5,41.58
2022-01-08,16364,6512014,6149,406287,3344,4,38.63
2022-01-09,13977,6525991,5311,411598,3349,5,38.97
2022-01-10,12276,6538267,4625,416223,3359,10,38.79
2022-01-11,17919,6556186,6763,422986,3368,9,38.67
2022-01-12,14500,6570686,5853,428839,3377,9,41.51
2022-01-13,16715,6587401,6239,435078,3389,12,38.32
2022-01-14,16246,6603647,6097,441175,3398,9,38.67
2022-01-15,15439,6619086,5346,446521,3403,5,35.62
2022-01-16,11239,6630325,4135,450656,3412,9,37.96
2022-01-17,9099,6639424,3518,454174,3422,10,39.27
2022-01-18,10135,6649559,3771,457945,3430,8,38.33
2022-01-19,11124,6660683,3633,461578,3437,7,33.54
2022-01-20,10668,6671351,3685,465263,3452,15,35.78
2022-01-21,10406,6681757,3873,469136,3471,19,38.45
2022-01-22,7935,6689692,2616,471752,3483,12,34.19
2022-01-23,4771,6694463,1686,473438,3497,14,36.89
2022-01-24,6792,6701255,2843,476281,3513,16,43.37
2022-01-25,9044,6710299,3343,479624,3525,12,37.72
2022-01-26,9406,6719705,3233,482857,3538,13,34.95
2022-01-27,8747,6728452,3081,485938,3550,12,36.49
2022-01-28,8472,6736924,2946,488884,3565,15,35.78
2022-01-29,5921,6742845,1825,490709,3576,11,32.34
2022-01-30,5081,6747926,1736,492445,3592,16,35.52
2022-01-31,5052,6752978,2015,494460,3608,16,40.58
2022-02-01,7688,6760666,3038,497498,3620,12,40.26
2022-02-02,7372,6768038,2474,499972,3637,17,34.54
2022-02-03,6274,6774312,2089,502061,3656,19,34.09
2022-02-04,6449,6780761,2023,504084,3668,12,32.14
2022-02-05,4794,6785555,1374,505458,3682,14,29.85
2022-02-06,3594,6789149,1121,506579,3696,14,32.58
2022-02-07,4295,6793444,1539,508118,3705,9,36.74
2022-02-08,5788,6799232,1799,509917,3718,13,32.2
2022-02-09,5015,6804247,1467,511384,3737,19,29.63
2022-02-10,4793,6809040,1403,512787,3752,15,30.34
2022-02-11,4351,6813391,1106,513893,3765,13,25.19
2022-02-12,3474,6816865,851,514744,3778,13,25.07
2022-02-13,2449,6819314,634,515378,3789,11,27.11
2022-02-14,2527,6821841,858,516236,3797,8,34.55
2022-02-15,4144,6825985,1048,517284,3814,17,24.93
2022-02-16,4081,6830066,960,518244,3822,8,24.19
2022-02-17,3792,6833858,800,519044,3837,15,21.94
2022-02-18,3418,6837276,739,519783,3845,8,22.62
2022-02-19,2584,6839860,472,520255,3853,8,19.5
2022-02-20,1985,6841845,465,520720,3865,12,24.69
2022-02-21,2008,6843853,454,521174,3874,9,24.85
2022-02-22,2794,6846647,751,521925,3878,4,27.06
2022-02-23,3459,6850106,737,522662,3889,11,22.15
2022-02-24,3189,6853295,657,523319,3895,6,21.42
2022-02-25,3119,6856414,599,523918,3907,12,19.14
2022-02-26,2461,6858875,466,524384,3915,8,19.91
2022-02-27,1847,6860722,377,524761,3924,9,21.33
2022-02-28,2076,6862798,518,525279,3931,7,25.53
2022-03-01,2946,6865744,547,525826,3936,5,19.42
2022-03-02,2863,6868607,638,526464,3948,12,21.94
2022-03-03,2532,6871139,494,526958,3956,8,20.34
2022-03-04,2458,6873597,424,527382,3966,10,17.86
2022-03-05,2179,6875776,397,527779,3969,3,19
2022-03-06,1573,6877349,284,528063,3977,8,19.33
2022-03-07,2210,6879559,472,528535,3979,2,20.77
2022-03-08,3085,6882644,539,529074,3983,4,18.09
2022-03-09,3097,6885741,580,529654,3991,8,21.02
2022-03-10,2540,6888281,471,530125,3996,5,19.49
2022-03-11,2298,6890579,503,530628,4000,4,22.41
2022-03-12,2502,6893081,395,531023,4005,5,16.87
2022-03-13,1986,6895067,438,531461,4009,4,23.11
2022-03-14,1862,6896929,476,531937,4013,4,26.32
2022-03-15,3186,6900115,578,532515,4016,3,18.58
2022-03-16,2751,6902866,568,533083,4018,2,21.56
2022-03-17,2950,6905816,605,533688,4021,3,20.68
2022-03-18,2576,6908392,564,534252,4029,8,22.59
2022-03-19,2433,6910825,479,534731,4035,6,20.84
2022-03-20,1491,6912316,343,535074,4040,5,24.48
2022-03-21,1860,6914176,485,535559,4048,8,27.69
2022-03-22,3217,6917393,769,536328,4050,2,24.9
2022-03-23,3170,6920563,740,537068,4054,4,24.92
2022-03-24,3493,6924056,822,537890,4056,2,23.22
2022-03-25,2785,6926841,691,538581,4061,5,26.18
2022-03-26,2505,6929346,529,539110,4065,4,21.88
2022-03-27,1777,6931123,459,539569,4069,4,27.52
2022-03-28,2210,6933333,570,540139,4076,7,26.11
2022-03-29,3472,6936805,873,541012,4080,4,26.18
2022-03-30,3460,6940265,867,541879,4083,3,25.9
2022-03-31,3529,6943794,909,542788,4087,4,26.78
2022-04-01,3619,6947413,858,543646,4093,6,24.34
2022-04-02,2825,6950238,664,544310,4097,4,24.53
2022-04-03,1955,6952193,520,544830,4100,3,27.57
2022-04-04,2591,6954784,823,545653,4106,6,32.57
2022-04-05,3896,6958680,1031,546684,4114,8,27.77
2022-04-06,3642,6962322,1010,547694,4117,3,28.61
2022-04-07,3887,6966209,920,548614,4125,8,24.83
2022-04-08,3660,6969869,933,549547,4133,8,26.42
2022-04-09,3405,6973274,822,550369,4136,3,24.79
2022-04-10,2243,6975517,591,550960,4140,4,27.37
2022-04-11,2845,6978362,839,551799,4145,5,30.58
2022-04-12,4434,6982796,1012,552811,4153,8,23.91
2022-04-13,4441,6987237,1025,553836,4161,8,23.82
2022-04-14,4082,6991319,1022,554858,4168,7,25.87
2022-04-15,4217,6995536,846,555704,4175,7,21.08
2022-04-16,2717,6998253,738,556442,4185,10,28.27
2022-04-17,2260,7000513,637,557079,4192,7,29.96
2022-04-18,2715,7003228,812,557891,4198,6,31.01
2022-04-19,4466,7007694,1124,559015,4204,6,26.15
2022-04-20,4938,7012632,1228,560243,4211,7,26.08
2022-04-21,4487,7017119,1038,561281,4221,10,24.05
2022-04-22,3610,7020729,968,562249,4232,11,27.45
2022-04-23,3589,7024318,838,563087,4247,15,24.71
2022-04-24,2912,7027230,676,563763,4254,7,24.11
2022-04-25,2330,7029560,700,564463,4266,12,31.33
2022-04-26,4839,7034399,1078,565541,4275,9,23.52
2022-04-27,4000,7038399,942,566483,4285,10,24.5
2022-04-28,4488,7042887,918,567401,4295,10,21.23
2022-04-29,3704,7046591,756,568157,4308,13,21.63
2022-04-30,3488,7050079,726,568883,4313,5,22.02
2022-05-01,2260,7052339,609,569492,4326,13,28.1
2022-05-02,2966,7055305,671,570163,4331,5,23.63
2022-05-03,3628,7058933,756,570919,4340,9,21.91
2022-05-04,3843,7062776,772,571691,4351,11,20.63
2022-05-05,3961,7066737,777,572468,4359,8,20.47
2022-05-06,3690,7070427,690,573158,4369,10,19.54
2022-05-07,2851,7073278,590,573748,4375,6,21.29
2022-05-08,841,7074119,134,573882,4384,9,17
2022-05-09,3225,7077344,822,574704,4390,6,26.79
2022-05-10,3156,7080500,654,575358,4401,11,21.67
2022-05-11,3134,7083634,585,575943,4409,8,19.5
2022-05-12,3202,7086836,603,576546,4421,12,19.27
2022-05-13,2346,7089182,470,577016,4427,6,20.8
2022-05-14,2635,7091817,450,577466,4435,8,17.69
2022-05-15,1847,7093664,355,577821,4443,8,20.03
2022-05-16,2125,7095789,479,578300,4450,7,23.15
2022-05-17,3275,7099064,546,578846,4461,11,18.26
2022-05-18,2357,7101421,469,579315,4468,7,20.58
2022-05-19,2844,7104265,490,579805,4475,7,19.02
2022-05-20,2280,7106545,355,580160,4480,5,15.88
2022-05-21,2219,7108764,291,580451,4489,9,13.84
2022-05-22,1495,7110259,232,580683,4499,10,15.99
2022-05-23,1644,7111903,320,581003,4503,4,20.56
2022-05-24,1868,7113771,389,581392,4510,7,21.25
2022-05-25,2958,7116729,454,581846,4515,5,16.02
2022-05-26,2205,7118934,363,582209,4520,5,17.01
2022-05-27,2169,7121103,341,582550,4525,5,16.97
2022-05-28,1811,7122914,259,582809,4526,1,14.8
2022-05-29,799,7123713,88,582897,4531,5,12.89
2022-05-30,2125,7125838,438,583335,4539,8,21.98
2022-05-31,2359,7128197,357,583692,4544,5,15.68
2022-06-01,2068,7130265,271,583963,4547,3,13.78
2022-06-02,1989,7132254,298,584261,4547,0,15.23
2022-06-03,1850,7134104,266,584527,4552,5,14.97
2022-06-04,1463,7135567,195,584722,4562,10,13.47
2022-06-05,1148,7136715,187,584909,4565,3,17.16
2022-06-06,1394,7138109,232,585141,4567,2,17.36
2022-06-07,2070,7140179,291,585432,4569,2,14.25
2022-06-08,2097,7142276,263,585695,4573,4,12.68
2022-06-09,1772,7144048,246,585941,4576,3,14.16
2022-06-10,1327,7145375,183,586124,4578,2,14.32
2022-06-11,1209,7146584,142,586266,4579,1,12.74
2022-06-12,1285,7147869,146,586412,4584,5,11.83
2022-06-13,1241,7149110,163,586575,4586,2,13.7
2022-06-14,1526,7150636,207,586782,4587,1,13.96
2022-06-15,1774,7152410,184,586966,4588,1,10.71
2022-06-16,1217,7153627,146,587112,4588,0,12.24
2022-06-17,1520,7155147,176,587288,4588,0,12.43
2022-06-18,1230,7156377,164,587452,4591,3,14.23
2022-06-19,734,7157111,65,587517,4595,4,8.86
2022-06-20,949,7158060,138,587655,4597,2,15.91
2022-06-21,1407,7159467,181,587836,4600,3,13.36
2022-06-22,1393,7160860,154,587990,4603,3,11.27
2022-06-23,1412,7162272,127,588117,4606,3,9.77
2022-06-24,1066,7163338,133,588250,4609,3,12.95
2022-06-25,1110,7164448,121,588371,4611,2,11.44
2022-06-26,824,7165272,92,588463,4612,1,11.65
2022-06-27,1035,7166307,128,588591,4613,1,13.33
2022-06-28,1370,7167677,168,588759,4614,1,12.41
2022-06-29,1449,7169126,173,588932,4617,3,12.91
2022-06-30,1104,7170230,199,589131,4619,2,18.84
2022-07-01,1016,7171246,157,589288,4623,4,16.04
2022-07-02,828,7172074,125,589413,4624,1,16.06
2022-07-03,921,7172995,116,589529,4627,3,13.14
2022-07-04,1118,7174113,180,589709,4628,1,17.35
2022-07-05,1294,7175407,247,589956,4631,3,19.94
2022-07-06,1128,7176535,188,590144,4632,1,17.11
2022-07-07,1202,7177737,230,590374,4635,3,20.38
2022-07-08,1078,7178815,191,590565,4637,2,17.81
2022-07-09,1086,7179901,191,590756,4641,4,17.77
2022-07-10,780,7180681,131,590887,4642,1,17.95
2022-07-11,974,7181655,177,591064,4645,3,18.58
2022-07-12,1148,7182803,250,591314,4646,1,22.04
2022-07-13,1363,7184166,264,591578,4647,1,19.66
2022-07-14,1080,7185246,235,591813,4650,3,22.22
2022-07-15,1131,7186377,246,592059,4652,2,22.46
2022-07-16,994,7187371,206,592265,4653,1,21.43
2022-07-17,892,7188263,180,592445,4654,1,20.74
2022-07-18,1057,7189320,304,592749,4655,1,29.33
2022-07-19,1396,7190716,320,593069,4657,2,23.5
2022-07-20,1214,7191930,265,593334,4659,2,22.9
2022-07-21,1134,7193064,275,593609,4662,3,24.96
2022-07-22,1061,7194125,217,593826,4664,2,21.58
2022-07-23,1024,7195149,232,594058,4667,3,23.93
2022-07-24,780,7195929,162,594220,4667,0,21.54
2022-07-25,945,7196874,218,594438,4671,4,23.92
2022-07-26,1309,7198183,298,594736,4672,1,23.38
2022-07-27,1286,7199469,238,594974,4673,1,18.97
2022-07-28,1170,7200639,257,595231,4673,0,22.65
2022-07-29,1333,7201972,318,595549,4673,0,24.31
2022-07-30,934,7202906,206,595755,4673,0,22.7
2022-07-31,757,7203663,157,595912,4673,0,21.27
2022-08-01,934,7204597,214,596126,4673,0,22.81
